////////////////////
/@@@@D@o@@@ooo@@@@@/
/@P@@o@@@@o@@@@D@@@/
/@-@@@--@@@D@@oo@-@/
/@@D@@---#---@ooo@@/
/@@@@@@oooDo@@@#--@/
/@@@---@D@@@@@@@@@@/
/oooo@-@@@@@@---D@@/
/ooo@@--D@@@-D@@@@X/
////////////////////f




////////////////////////////////////////
/@@@@@D@@-@@@@D@o@@@@@@o@@o@@@@D@-@-@@o/
/@oPo@@@@@@@-@@-@---@@@D@o@--#---@@@@@o/
/o@@@@ooo@@@@--@@@@@@@-@-@@@@@@@@@@o@D@/
/@@@@@@@@o@@@@@@@o----@@@@@@#---@@@@ooo/
/////////////////////////////////@@@@o@/
/@@D@@@@@@-@@@@@@@-@@@@@@@@@-@o@@o@@@@o/
/o@@@@ooo@@@@--@@@@@@@-@-@@@@@@@@@@o@D@/
/@@@---@D@@@@@@@@@@@-@@@--@@@D@@oo@-@@@/
/@-@@@--@@@D@@oo@-@@@@@@@oooDo@@@###@-@/
/@@@@@o/////////////////////////////////
/@--@@@@@@ooo@@@#----D@@@oooo@@@@@oo@@@/
/@@-@@@@@ooo@@@D@@@@@o---@@@@o@@@@@@@@X/
/@@@@@-@@@@o@@@@oo@@@@@o@@o@@D@@@@@--@D/
/@@D@@@@@@-@@@@@@@-@@@@@@@@@-@o@@o@@@@o/
////////////////////////////////////////f




////////////////////////////////////////
/Poo@@@o@@@@/D@oo@@@-@@@@--oo@@@@@@@o@D/
/@@@@@@@@@@@@@@@@@@@-@@@@@@@@@@--@@@D@@/
/--------------------------------------/
/@@o@-@/@@D@@---#----ooo@@@@@@@@@@oooo@/
/ooD@@@/@-@@@--@@@D@-oo@-@@@@---@@@@@D@/
/@@@@@@@@@@o@@@@@@@@-@@@---@@D@@@D@@@@o/
/@@-@@@@@ooo@@@D@@@@-o---@@@@o@@@@@@@@X/
/@@@@@-@@@@o@@@@oo@@-@@o@@o@@D@@@@@--@D/
/@-@@@--@@@D@@oo@-@@-@@@@@@@@@@@@@@@@@@/
////////////////////////////////////////f




/////////////////////////
/@--@@@@@@@@-@@@@--@@D@-/
/@P@@@o@/@o@-@@///@@-o@@/
/@@@@@D@/@D@-@@/@@@-@oo@/
/////////@@@---/@@@@@@D@/
/@@oo@@@/@---@@//////////
/@@D@@-----@@@@@@@@oo@@@/
/@@@@-@@@@@@o@@o@@@ooo@@/
/oo@@@@@@@@@@@@@@@@o@@--/
/XD@@@@@@@@@@@-o@@@D@@@@/
/////////////////////////f




////////////////////////////////////////
/o@//@/oo@/@@@o/o@@o@@@@/@@@o@@@@@o/@D@/
/@@P/@D@o@/@@@///@@/@o@@@@o@@o@o@@@/@/o/
/@@@@/@@oD@@o@@@@/@@@@@o@//o@@@@@@@/@///
/D@/@@/o/o@@o@@@@/@@@o@@@@@@o@oo@@@@@@//
/o@/@@@/@@o@//@@o@//D@@@@@@@o@oo@@@@@@//
/oo@@o@@@@/@@@o@@@@@@o@oo@@@@@@o@@D//@@/
/@@o@//@@o@oo@@@/@@@@o@oo@@@@@@/@@o@/@o/
/@@/@@@D@@@@@@D@o@@//o@@o@/@/o@@/o@@D@o/
/o@o@@@@/@//@@D@o@@//o@@o@@D@/@@@/@@o@//
/@o@//@@@@@oo@o@@Do/@/o@@/o@@@/o@@D@o@@/
//@//@@@@@@oo/o@@o@/@//@@@/@@o@//@@o@///
/@/@o@o@/@@@//o@@o@@@@/@@@o@@@@@//@o@///
/@/@o@o@/@D@/@/o@@/o@@@@o@@o@oo@@@@/@@@/
//@@/o/o@@o@@@@/@@@D@@@/@o/@@@@@@/@//@D/
//@@@//o@@/@D@@@/o@@o@o@@@o@o/o@@@@@/@@/
//@D@@@@o@o//@@o@//o@@@@@@@o@/o@@@@@/@@/
/@@o@@@@/@@@o@@@@@@o@oo@@@@@@/@@o@/@@@//
/o@//@@o@//@@@/@@@@o@oo@@@@@@/@@oD@@o@X/
//@@@o@@@@@@o@oD@@@@@@o@@@//@@/o@@D@/@@/
/oo@@@/@@@@@o@oD@@@@@@/@@o@/D@D@o/@o@@@/
////////////////////////////////////////f















